20
####################
#   *             @#
#H#####H      H#####     
#H     H      H    # 
#H     H------H    #       
#H     H      H    # 
#H#####H      H---##      
#H     H  *   H    #   
#H     H######H    #        
#H#####H      H    #   
#H      ------H  % #     
###H####       ###H#                 
#  H              H#   
#  H--------      H#  
###H       ####H####  
#  H           H   #  
#  H-----------H   #  
#  H               # 
#  H   %      *    # 
####################